111111111111111111111111
100000000000000000000001
100001111111111111110001
100000000000000000000001
101000000000000000000001
101000100011100100000001
101000100010100100000001
101000100010000100000001
101000100011111100000001
101000000000000000000001
101000000000000000000001
101111111111000000000001
100000000000000111110001
100000000000000111110001
100000000000000111110001
100000000000000000000001
100000000000000000000001
101111111110011111111101
101000000000000000000101
101000000000000000000101
101000000000000000000101
101111111111111111111101
100000000000000000000001
111111111111111111111111
